F 105,105,105
C 135,206,235

NO textures/gray_hitler.png
SO textures/gray_hitler.png 
WE textures/gray_hitler.png
EA textures/gray_hitler.png 

        1111111111111111111111111
        1000000000110000000000001
        1011000001110000000000101
        10011000000000000000000001
11111111101100000111100000010001001
100000000011000001110 1001111111111111
111101111111110111000000100011
1111011111111101 1101010010001
110000001010101110000001000111
10000N00000000001100000010001
10000000000000011101010010001
11000001110101011 111011110011
11110111 111010101 1111010001
11111111 111111111 1111111111
