F 220,100,0
C 225,30,0

NO textures/wall_1.xpm
SO textures/wall_2.xpm
WE textures/wall_3.xpm
EA textures/wall_4.xpm

        1111111111111111111111111
        1000000000110000000000001
        1011000001110000000000001
        10011000000000000000000001
11111111101100000111100000010001001
1000000000110000011111001111111111111
111101111111110111000000100011
1111011111111101 1101010010001
110000001010101110000001000111
10000000000000001100000010001
10000000000000001101010010001
11000001110101011 11101111W011
11110111 111010101 1111010001
11111111 111111111 1111111111
